NO textures/1.png
F 64,64,64                  
SO textures/2.png
WE textures/3.png
EA textures/4.png
C 64,64,64



          11111111111111111111111
1111111110000000000111011
1111000101000111101111111111
111100000000000011000000001
    110000100000001000N0010001111111
1111010000000111110000001111100011
111111111111111  1111111111111111  111111
111111111111111  1111111111111111  111111
111111111111111  1111111111111111  111111
111111111111111  1111111111111111  111111
111111111111111  1111111111111111  111111
111111111111111  1111111111111111  111111
111111111111111  1111111111111111  111111