NO bonus/textures/1.png
SO bonus/textures/2.png
WE bonus/textures/3.png
EA bonus/textures/4.png
F 41,39,46                  
C 101,101,85




11111111111111111111111
1111111110000000000111011
111100010100011110111111111
111100000000000011000000001
110000100000001000000100001111111
1111010000000111110000N001111100011
111111111111111  1111111111111111  111111
